111111111111111111
1000C00P00P000E001
111111111111111111