111111111111111111
1000C00E00P00E0001
111111111111111111