1111111111111111111111111111
1001000000000000000000000001
10000111110000011100000000C1
1P0011E000000000000000000001
1110000000000000000000111111
1000000001010001000000000001
10M0000000000000000000011111
1000000000000000000000000001
1001110000000000000000000001
1000000011100000000000000001
1000000000100000000000000001
1000000011100000000000000001
1100011000000000000000000001
1111011000111111000000000001
100C001000111111000000000001
1111111111111111111111111111