1111111111111111111111111111
100000000000000000000C1P0001
1000000000000000011111111001
1000000000CCCCC0000000000001
1000001111111111111000000001
1000000000000000000000000001
1000000000000000000000000001
10000000000000000C0000000001
1000000000000001111100000001
1000000000000000000000000001
1000001111111111000000000001
1000000000000000000010000001
1E000000000000000000100C0001
1111111111111111111111111111