111111111111111111
1000C00E0000000000
111111111111111111