111111111111111111
1000C00000P0000001
111111111111111111