111111111111111111
1000C00E0000000001
100000000000000001