100000000P00000001
1000C00E0000000001
111111111111111111